111111111
101000E01
101111101
1000P0001
100000001
11000C001
111111111