111111111
100P11E01
100110011
110000C11
111111111