111111111
100P11E01
100110011
11C000C11
111111111