111111
1C10C1
101E01
1000P1
111111