111111111
101000E01
101111101
1000P0001
100000001
110000001
111111111