111111111
1C10C0E01
101111101
1C00P00C1
100000001
11C0000C1
111111111