1E1111
1010C1
1C1101
1100C1
110111
1EP111
111111