111111111
100P11E01
1100110C1
110000011
111101111