111111111
1C1EC0001
101100001
1000P0001
111100001
11C000001
111111111