1111111111
10C0010001
10E0010001
100000P001
10000000E1
100C000001
100C000001
1111111111