1111111111
1000010001
1000011101
1C00000001
10E0P000X1
100000C001
10000C0001
1111111111