1111111111
1000110111
100010X011
1C00110111
10E0P10111
100000C001
10000C0001
1111111111