1111111111
11C001E011
1000010111
100C00P0X1
1111111111