1111111
1E0C111
1000X01
10P01C1
10C0001
1111111