1111111
1E0X111
1000001
10P01C1
1000001
1111111